area boundary	area boundary	black pit	actOnStep,blockGround,blockAir,blockWater,blockLava	moveToArea::
ivy stone wall	ivy stone wall	ivy stone wall	blockGround,blockAir,blockWater,blockLava	
diggable small stone wall	diggable stone wall	diggable small stone wall	diggable,actOnStep,blockGround,blockAir,blockWater,blockLava	dig::floor
green moss wall	mossy wall	green moss wall	blockGround,blockAir,blockWater,blockLava	
blue wall	stone wall	blue wall	blockGround,blockAir,blockWater,blockLava	
brown stone wall	stone wall	brown stone wall	blockGround,blockAir,blockWater,blockLava	
diggable ice wall	diggable ice wall	diggable ice wall	diggable,actOnStep,blockGround,blockAir,blockWater,blockLava	dig::ice floor
weapon store	weapon store	weapon store	blockGround,blockAir,blockWater,blockLava	
ice	ice floor	ice	blockWater,blockLava	
dark sand	sand	dark sand	blockWater,blockLava	
inn	inn	inn	blockGround,blockAir,blockWater,blockLava	
floor	floor	floor	blockWater,blockLava	
water 2	deep water	water 2	blockGround,blockLava	
water 3	deep water	water 3	blockGround,blockLava	
water 1	shallow water	water 1	blockGround,blockLava	
snow	snow	snow	blockWater,blockLava	
water 4	deep water	water 4	blockGround,blockLava	
forest	forest	forest	blockWater,blockLava	
diggable hot stone wall	diggable hot stone wall	diggable hot stone wall	diggable,actOnStep,blockGround,blockAir,blockWater,blockLava	dig::cold lava floor
big stone wall	stone wall	big stone wall	blockGround,blockAir,blockWater,blockLava	
diggable ivy stone wall	diggable ivy stone wall	diggable ivy stone wall	diggable,actOnStep,blockGround,blockAir,blockWater,blockLava	dig::floor
diggable rock	diggable rock	diggable rock	diggable,actOnStep,blockGround,blockAir,blockWater,blockLava	dig::dark sand
black pit	black pit	black pit	blockGround,blockLava,blockWater	
charcoal floor	floor	charcoal floor	blockWater,blockLava	
small stone wall	stone wall	small stone wall	blockGround,blockAir,blockWater,blockLava	
wood floor	floor	wood floor	blockWater,blockLava	
dock	dock	dock	blockLava	
lava	lava	lava	blockWater,blockGround	
diggable green moss wall	diggable mossy wall	diggable green moss wall	diggable,actOnStep,blockGround,blockAir,blockWater,blockLava	dig::dark sand
diggable blue wall	diggable stone wall	diggable blue wall	diggable,actOnStep,blockGround,blockAir,blockWater,blockLava	dig::blue floor
magic store	magic store	magic store	blockGround,blockAir,blockWater,blockLava	
hot stone wall	hot stone wall	hot stone wall	blockGround,blockAir,blockWater,blockLava	
diggable big stone wall	diggable stone wall	diggable big stone wall	diggable,actOnStep,blockGround,blockAir,blockWater,blockLava	dig::floor
snowy rock	snowy rock	snowy rock	blockGround,blockAir,blockWater,blockLava	
blue floor	floor	blue floor	blockWater,blockLava	
diggable brown stone wall	diggable stone wall	diggable brown stone wall	diggable,actOnStep,blockGround,blockAir,blockWater,blockLava	dig::dark sand
ice wall	ice wall	ice wall	blockGround,blockAir,blockWater,blockLava	
swamp	swamp	swamp	blockWater,blockLava	
sand	sand	sand	blockWater,blockLava	
rock	rock	rock	blockGround,blockAir,blockWater,blockLava	
debug	debug	debug		
hot lava floor	hot lava floor	hot lava floor	blockWater,blockLava	
grass	grass	grass	blockWater,blockLava	
road	road	road	blockWater,blockLava	
cold lava floor	cold lava floor	cold lava floor	blockWater,blockLava	
